fff#fd#ff#@v@f@@
#f#ttd##f#tv##f#
##dddd#####d##tt
#fd###t##f#vf###
#fd####f#fvv#f##
#fd#f##ffvvf@f##
##dt#f##vv#@ffft
#tdf###tddt#ffff
#fdf####fvf@@@f#
#fdf###f@v@f###t
##t#####vv######
#td##f@vvff@@#@#
##d####v####@@@#
